Greek	English
ἀγαθὸς, ὴ, ὸν	good, brave
ἄγαλμα	ornament
ἄγαμαι	admire
ἄγαν	excessively, too much
ἀγανακτέω	be displeased
ἀγγεῖον	bucket, jar
ἀγγέλλω	report, tell announce
ἄγγελμα	tidings, announcement
ἄγγελος	messenger
ἀγέλη	herd
ἀγεννής, ες	ignoble
ἄγκυρα	anchor
ἀγνοέω	be ignorant of, fail to perceive
ἄγνοια	ignorance, misunderstanding
ἀγνώμων, ον	unfeeling, reckless
ἀγορὰ	marketplace, place of assembly
ἀγοραῖος, ον	of the market
ἀγορεύω	to speak, harangue
ἄγρῐος, α, ον	wild
ἄγροικος, ον	countrified, clownish, rude
ἄγρος	field, country (as opposed to town)
ἀγύρτης	vagabond impostor, quack
ἀγχίνους, ουν	cunning, shrewd
ἄγω	lead, bring
ἀγὼν	contest
ἀγωνίζομαι	content, struggle, fight
ἀγωνισμὸς	rivalry
ἀδεὴς, ες	fearless, secure
ἄδεια	assurance of safety, safe conduct
ἀδελφὸς	brother
ἀδεῶς	without fear, securely
ἄδηλος, ον	unseen, invisible
ἀδῄωτος	free from ravages, inviolate
αδικέω	do wrong, injure
ἄδικος, ον	wrong, unjust
ἀδίκως	unjustly, undeservedly
ἀδοξία	disgrace
ᾅδου	place of the dead, Hades
ἀδύνατος	unable, impossible
ἅδυτον	shrive
ᾄδω	sing
ἀεὶ	for ever, always
ἄελπτος	hopeless
ἀετὸς	eagle
ἀηδὴς, ες	unpleasant, disagreeable
ἀὴρ	the air
ἀθἀνατος, ον	immortal
ἀθλητὴς	athlete
ἄθλιος	wretched
ἀθροἰζω	collect, assemble, muster
ἀθρόος	collected, gathered, in crowds
ἀθυμἐω	despond, lose heart
αἰγιαλος	sea-coast, beach
αἰδἐομαι	be ashamed, feel shame
αἰδὼς	sense of shame, shame, respect
αἴλουρος	cat
αἳξ	goat
αἱρεω	take, (mid.) take, choose.
αἴρω	lift, get under way (of ships), start
αἰσθἀνομαι	perceive
αἰσχρολογία	scurrilous talk, abuse
αἰσχρὸς	ugly, shameful
αἰσχυνομαι	be ashamed, feel shame
αἰτέω	ask, demand, beg
αἰτία	cause, blame, accusation
αἴτιος, α, ον	responsible for
το αἴτιον	the reason of
αἰφνίδιος	sudden
αἰφνιδίως	suddenly
αἰχμάλωτος	prisoner (of war)
αἰων	life, age, eternity
ἀκάτιον	little boat, skiff
ἀκινήτος, ον	motionless, unmoved
ἀκινήτως	immoveably
ἄκλητος	uncalled, uninvited
ἄκμαιος, α, ον	ripe, blooming, vigorous
ἀκολασία	excess, riotous living
ἀκόλουθος	attendant, follower
ἀκοντίζω	hurl a javelin, shoot
ἀκόντιον	javelin
ἀκοντιστὴς	javelin-man
ἀκούσιος, ον	unwilling, unintentional
ἀκούω	hear, be spoken of
ἅκρα	promontory, headland
ἀκρατὴς	powerless, without self-control
ἀκράχολος, ον	quick to anger, passionate
ἀκριβῶς	precisely
ἀκροατὴς	listener, pupil
ἀκροβολίζομαι	skirmish
ἀκροβόλισις	skirmishing
ἄκρον, α, ον	peak, height, extremity, tip
ἀκρωτήριον	promontory, headland
ἀλάζων	impostor
ἀλγέω	suffer pain, be hurt, be ill
ἀλείφω	anoint, besmear
ἀλεκτρυὼν	rooster
ἀλήθεια	truth
ἀληθὴς, ὲς	true
ἀληθῶς	really, truly
ὡς ἀληθῶς	in very truth
ἁλιεὺς	fisherman
ἅλις	enough
ἁλίσκομαι	be taken, be caught
ἀλλὰ	but, yet still
ἀλλᾶς	a sausage
ἀλλάσσω	to change
ἄλλῃ	another way
ἄλλος	other, another, the rest (of)
ἄλλοσε	elsewhere
ἄλλότριος	of others, alien, foreign
ἀλλοτρίως	strangely, unfavourably
ἀλλόφυλος	of alien race
ἄλλως	otherwise, in other respects
ἀλώπηξ	fox
ἅμα	together, at the same time
ἀμαθὴς	ignorant
ἀμαθία	ignorance, stupidity
ἅμαξα	wagon
ἁμαρτάνω	miss, err, make a mistake
ἁμάρτηρα	a slip, blunder
ἁμαρτία	error, mistake
ἀμελέω	neglect, disregard
ἀμνημονέω	to be unmindful of, forget
ἀμοιβὴ	recompense
ἄμοιρος	without share in
ἄμορφος	unshapely, unsightly
ἀμουσία	want of skill (in music, etc.)
ἄμπελος	vine
ἀμύνω	keep off, aid; (mid.) defend oneself
ἀμφιέννυμι	clothe
ἀμφότερος, α, ον	both
ἄμφω	both
ἂν	[conditional particle]
ἀνὰ	up, along
ἀναβαίνω	go up, mount, ascend, embark
ἀναβιώσκομαι	revive
ἀναβλέπω	look up
ἀναβοάω	cry out, lift up one's voice
ἀναγιγνώσκω	read
ἀναγκάζω	compel
ἀνάγκη	necessity
ἀναδεώ	bind up; (mid.) tow a ship
ἀναζητέω	look up, search (out)
ἀναίδεια	effrontery, impudence
ἀναίρεσις	burial
ἀναιρέω	take up, kill, destroy
ἀναίτιος	free from guilt, not to blame
ἀνακαλέω	call back, recall, (mid.) call upon, appeal to
ἀνακαλύπτω	uncover
ἀνάκλησις	calling on, invocation of
ἀνακοινόω	communicate
ἀνακόπτω	beat back
ἀνακρεμάννυμι	hang up
ἀνάκρισις	inquiry
ἀναλαμβάνω	take up, take (back), regain
ἀναλίσκω	use up, spend, waste; (mid.) kill oneself
ἀναμένω	wait, await, abide
ἄνανδρος, ον	cowardly, a coward
ἀνανεύω	refuse, deny
ἀνάξιος	unworthy
ἀναπαύω	stop, rest
ἀναπέμπω	send up, send back
ἀναπηδάω	spring up, leap up
ἀναπληρόω	fill up, refill
ἀναρπάζω	snatch up
ἀναρρήγνυμι	break open, burst
ἀνάστασις	removal
ἀνασταυρόω	impale
ἀνατείνω	stretch forth
ἀναχωρέω	withdraw, retreat
ἀναψύχω	refresh
ἀνδρεῖος, η, ον	manly, courageous, brave
ἀνδρείως	like a man, bravely
ἀνδριαντοποιΐα	sculpture
ἀνδριαντοποιὸς	sculptor
ἀνδριὰς	statue
ἀνειλέω	crowd together
ἀνέκπλκτος, ον	dauntless
το ἀνέκπλκτον	dauntlessness
ἀνεκτὸς	bearable, tolerable
ἀνελεύθερος	illiberal, ungentlemanly
ἀνέλκω	draw up
ἄνεμος	wind, breeze
ἀνέρχομαι	go up, return
ἄνευ	without
ἀνήκεστος	irreparable, incurable
ἀνήρ	man, husband
ἀνθίστημι	oppose
ἀνθρώπινος, η, ον	human
ἄνθρωπος	man
ἀνθυπάγω	prosecute in turn
ἀνίημι	send forth
ἀνίστημι	raise up, stand up
ἀνοιγω	open
ἀνοικοδομἐω	rebuild
ἀνόμοιος, ον	disimilar, unlike
ἀνοσιότης	wickedness
ἀνταγωνίζομαι	struggle
ἀντεῖπον	answer (no present tense)
ἀντέχω	hold out, withstand
ἀντί	in return for, instead of
ἀντίδικος	party to a lawsuit
άντιλέγω	say in answer, raise objections
ἀντίπαλος	antagonist
ἀντιπέμπω	send in return
ἀντιπέρας	opposite
ἀντιποίεω	lay claim to
ἀντίσχω	last
ἀντιτάσσω	draw up against
ἀντιτέχνησις	counter-manouvering
ἀνύποπτος, ον	unsuspected
ἀνύτω	effect, accomplish, finish, make haste
ἄνω	up, above
ἀνώγεων	upper room, chamber
ἄνωθεν	from above
τὸ ἄνωθεν	the top part
ἀξιοθέατος, ον	worth seeing
ἄξιος, α, ον	worth, worthy, deserving
ἀξιόω	demand, require, claim, think fit to
ἀπαγγέλλω	report
ἀπαγορεύω	forbid
ἀπάγχω	hang; (mid.) hang oneself
ἀπάγω	lead away, lead off, bring him
ἀπαίδευτος, ον	ignorant
ἄπαις	childless
ἀπαλλαγὴ	(noun) release, dissolution
ἀπαλλάσσω	release, send away
ἀπαξιόω	disdain, disown
ἀπαράσκευος, ον	unprepared, without preparation
ἅπας, ασα, αν	all, one and all
ἀπατάω	outwit, decieve, cheat
ἀπάτη	trick(ery), deception
ἄπεδος	level
ἀπεικάζω	liken to
ἀπειλέω	threaten
ἄπειμι	go away (from ἰέναι, to go)
ἄπειρος, ον	ignorant of
ἀπελαύνω	drive (something) away
ἀπέραντος, ον	boundless, immense
ἀπερίσκεπτος	inconsiderate
ἀπερισκέπτως	inconsiderately
ἀπέρχομαι	depart, come back
ἀπέχω	keep off; (mid.) hold off from
ἀπηλιώτης	the east wind
ἀπιστέω	disbelieve
ἁπλῶς	plainly, in a word
ἀπό	from, away from
ἀποβάθρα	ladder (for leaving a ship), gangway
ἀποβαίνω	go forth, disembark
ἀποβἀλλω	throw away, lose
ἀπογεύομαι	taste of
ἀπογίγνομαι	to be removed, die
ἀποδείκνυμι	show, produce, appoint
ἀποδημέω	go abroad
ἀποδιδράσκω	run away
ἀποδίδωμι	give back, pay, give up
ἀποζάω	live upon, live off
ἀποθνήσκω	die, be put to death
ἀποκάμνω	break down with weariness
ἀπόκλῃσις	closing
ἀποκλίνω	turn aside
ἀποκομίζω	carry away; (pass.) depart
ἀποκρίνω	separate; (mid/pass) answer, reply
ἀποκτείνω	kill
ἀπολαύω	enjoy
ἀπόλλυμι	destroy, lose; (mid.) perish
ἀπολογέομαι	speak in defence, defend oneself
ἀπολογία	plea, defence
ἀπολύω	release, acquit
ἀπονοστέω	return home
ἀπόπειρα	trial, experiment
ἀποπέμπω	send away
ἀποπίπτω	fall off
ἀποπλέω	sail off, sail away
ἀποπνέω	blow from
ἀποπνίγω	choke; (pass.) be drowned
ἀπορέω	be at a loss
ἀπόρημα	difficulty
ἀπορία	difficulty, want
ἄπορος, ον	impassable, unmanageable
ἀπορρήγνυμι	snap off
ἀπορρίπτω	throw aside, throw away, blurt out
ἀπόσπασμα	that which is torn off, a rag, a shred (of something)
ἀποσπάω	drag away; (pass.) be separated from
ἀπόστασις	secession, revolt
ἀποστέλλω	despatch
ἀποστερέω	rob, deprive
ἀποστρέφω	avert
ἀποσφάζω	slay
ἀποτειχίζω	blockade
ἀποτελέω	finish (off)
ἀποτίνω	pay
ἀποτρέχω	run off
ἀποτυγχάνω	miss (a mark)
ἀποφαίνω	prove, show clearly
άποφέρω	carry off, obtain
ἀποφεύγω	escape
ἀποφραγνύω	block up
ἀποχωρέω	retreat, depart
ἀποψηφίζομαι	vote not guilty, acquit
ἄπρακτος, ον	without success
ἀπρεπής, ες	unseemly
ἀπροσδόκητος, ον	unexpected
ἀπροσδοκήτως	unexpectedly
ἅπτω	to kindle, set fire to; (mid.), cling to, take up
ἄπωθεν	from far off
ἀπωθέω	thrust off, repel
ἄρα	therefore, so, then
ἆρα	[interrogative particle]
ἀράχνιον	spider's web
ἀργία	laziness
ἀργύριον	silver, money
ἄργυρος	silver
ἀρέσκω	satisfy, please (someone)
ἀρετή	excellence, virtue
ἀριθμέω	count, reckon
ἀριστεῖα	prize of valour
ἀριστερός, ά, όν	left (hand)
ἄριστον	breakfast
ἀριστοποιέομαι	to get breakfast
ἄριστος, η, ον	best, bravest
ἀρκέω	avail, suffice, be enough for
ἄρκτος	bear
ἁρμόζω	fit, adapt
ἁρπαγή	robbery, plundering
ἁρπάζω	carry off, snatch up, plunder
ἄρτι	just now, lately
ἀρτίως	just now, lately (same as ἄρτι)
ἄρτος	loaf, bread
ἀρύομαι	draw (water)
ἀρχαῖος	ancient
ἀρχή	beginning, sovereignty, government
ἄρχω	command; (mid.) begin
ἄρχων	ruler, magistrate, archon
ἀσαφής, ές	indistinct
ἀσεβέω	act impiously
ἀσεβής, ές	impious
ἀσθενής, ές	weak, feeble
ἀσκός	(wine)skin
ἄσμα	song
ἀσμένως	gladly
ἀσπάζομαι	embrace, greet, welcome; bid farewell
ἀσπίς	shield
ἀστέγαστος, ον	without roof or cover
ἀστεῖος, ον	jocular, humorous, witty
ἀστός	citizen, fellow-citizen
ἀστρονόμος	astronomer
ἄστυ	city
ἀσύνετος, ον	stupid
ἀσφάλεια	safety
ἀσφαλής, ές	safe, secure
ἀσχήμων, ον	unsightly, clumsy
ἀτακέω	live disorderly
ἄτακτος, ον	out of order, disorderly
ἀτακτῶς	without order
ἀτάρακτος, ον	undisturbed
ἅτε	as
ἀτείχιστος, ον	unfortified
ἀτερπής, ές	unpleasing, joyless
ἀτιμάζω	dishonor, despise
ἄτιμος, ον	disgraced, discredited
ἀτρεμία	quiet, tranquility
αὖ	again, on the contrary
αὐθάδης, ες	self-willed, obstinate, perverse
αὐθημερόν	the same day
αὖθις	again
αύλή	court(yard), hall
αὐλητική	flute-playing
αὐλίζομαι	encamp
αύλός	flute
αὐξάνω	grow, increase, rise
αὖος, η, ον	dry
αὐστηρός, ά, όν	rough, harsh, strict, austere
αὐτίκα	immediately
αὐτοβοεί	without a blow (lit. 'by a mere shout')
αὐτόθι	there, on the spot
αὐτομολέω	run away, desert
ἀυτόμολος	deserter
αὐτοῦ	there
αὐτοφυής, ές	growing of itself, wild, indigenous
αὐτοχειρίᾳ	with one's own hand
αὐχήν	neck
ἀφαιρέω	take (away), bear off
ἀφανής, ές	invisible
ἀφανίζω	make away with; (pass.) vanish, disappear
ἀφέλκω	drag away
ἀφίημι	discharge, let go, give up, forgive
ἀφικνέομαι	arrive, come
ἄφιξις	arrival
ἀφίστημι	put away; stand off, withdraw, revolt
ἀφοβία	fearlessness
ἀφομοιόω	make like
ἀφορμάομαι	start, set out
ἄφρων, ον	foolish
ἀφυής, ές	without talent
ἀφύλακτος, ον	unguarded, off one's guard
ἀχαριστία	ingratitude
ἀχάριστος, ον	ungrateful
ἄχθομαι	be vexed, object to
ἀχρεῖος, ον	useless
ἄχρηστος, ον	unserviceable
βαδίζω	walk
βαίνω	go
βακτηρία	staff, stick
βακχεύω	revel
βαλλάντιον	purse
βάλλω	throw, shoot, hurl, pelt
βάρβαρος	barbarous, foreign
βαρέως	heavily
βαρύνω	load, weigh down
βαρύς	heavy
βασιλεία	kingdom
βασίλεια	queen
βασιλεύς	king
βασιλεύω	reign, rule over
βασιλικός	royal
βάσις	step, footing
ἐκ τῆς βάσεως	off his legs
βέβαιος	sure, certain
βέλος	arrow, dart
βέλτιστος	best, bravest
βελτίων	better
βῆμα	platform/pulpit (for speaking)
βία	(noun) force
βιάζω	force; (mid.) force one's way
βιαίως	forcibly, by force
βιβάζω	make to go, embark (troops)
βιβλίον	treatise, book
βίος	life
βλάπτω	harm, hurt, damage, injure
βλέπτω	look (at), see
βοάω	shout, cry out, exclaim
βοή	(noun) shout, cry
βοηθέω	come to the rescue, help
βορά	food
βορέας	north-wind
βόσκημα	fattened calf
βουκόλος	herdsman
βούλευμα	(noun) plan
βουλευτής	councillor
βουλεύω	determine, resolve
βοῦς	ox, cow
βραδύς, εῖα, ύ	slow
βραχίων	arm
βραχύς, εῖα, ύ	short, little; a little while
βρέχω	wetten, drench; (of gods) send rain
βροντή	thunder
βρῶμα	food
βῶμος	altar
γάλα	milk
γαλήνη	calm
γαμέω	marry
γάμος	wedding
γάρ	for
γαστήρ	belly
γε	at least, at any rate
γελάω	laugh
γέλοιος, α, ον	absurd, ridiculous
γέλως	laughter
γενναῖος, α, ον	noble, glorious
γενναίως	nobly
γεννάω	beget
γένος	descent
γερουσία	Senate
γέρων	old man
γεύομαι	taste
γερωγία	husbandry
γεωργός	farmer
γῆ	earth, land, country
γήδιον	bit of ground, small farm
γῆρας (gen. γήρως)	old age
γηράσκω	grow old
γίγνομαι	be born, be, become, happen, occur
γιγνώσκω	perceive, know
γλίσχρος, α, ον	sticky, (figuratively) stingy
γλυκύς, εῖα, ύ	sweet, agreeable, palatable
γλῶσσα	tongue, language, pronunciation
γνάθος	jaw
γνώμη	mind, opinion
γνώριμος, ον	known
ὁ γνώριμος	an acquaintance
γοῦν	at all events, at any rate
γραμματεύς	clerk
γραφή	picture, painting; indictment, prosecution
γράφω	draw, paint, write
γυνάζομαι	exercise, practise, gymnastics
γυμνός, ή, όν	stripped, undressed, naked
γυνή	woman, lady, wife
γύψος	chalk
δαιμόνιος, α, ον	divine, supernatural
δάκνω	bite
δάκρυον	tear
δακρύω	weep
δακτύλιος	ring
δάκτυλος	finger
δαλός	firebrand
δανείζω	lend, (mid.) borrow
δαπανάω	expend
δαπανηρός, ά, όν	extravagant
δέ	but, and
δείδω	fear
δείκνυμι	show, demonstrate
δείλη	afternoon, evening
δειλία	cowardice
δειλός, ή, όν	cowardly
δεινῶς	terribly
δειπνέω	dine
δεῖπνον	dinner
δειπνοποιέομαι	dine
δέκα	ten
δέκατος	tenth
δελφίς	dolphin
δένδρον	tree
δεξιός, ά, όν	right (hand); skillful, clever
δέρμα	skin
δεσμός	fetter
δεσμωτήριον	prison
δεσπότης	master, lord
δεύτερος	second, next
δέχομαι	accept, receive, entertain
δέω (fut. δήσω)	fetter, imprison
δέω (fut. δεήσω)	it is necessary, right
δή	indeed
δηλονότι	manifestly, clearly
δῆλος	clear, plain
δηλόω	make clear, make known
δημηγορέω	harangue, speak in public
δήμιος	executioner
δημοκρατία	popular government, democracy
δῆμος	the people, the commons
δημόσιος, α, ον	publicly, at the public expense
δῃόω	ravage, lay waste
δήπου	surely, doubtless, I imagine
διά	(gen.) through, by means of; (acc.) on account of, owning to, for the sake of
διαβαίνω	cross, pass over
διαβάλλω	slander
διάβασις	passage
διαγγέλλω	announce, notify
διαγιγνώσκω	determine, decide
διαγράφω	cancel, strike out
διάγω	lead through; pass/spend time
διαδίδωμι	spread abroad (rumours etc)
διαιρέω	divide, distribute, determine
δίαιτα	way of living
διαιτάομαι	live disorderly
διακαρτερέω	hold out
διάκειμαι	be disposed, feel, be in such and such state
διακελευσμός	cheering on, exhortation
διακομιδή	(noun) carrying across, carrying over
διακομίζω	carry over/across
διακονία	service
διάκονος	servant
διακόπτω	cut through
διακόσιοι, αι, α	two hundred
διακοσμέω	to marshal out, distribute, arrange
διακρίνω	distinguish, decide
διακωλύω	prevent
διαλέγομαι	converse, talk
διαλείπω	fall short of; (of time) elapse
διάλογος	conversation
διαλύω	break up, destroy
διαμάχομαι	fight it out
διαμένω	remain, persevere
διαμετρέω	measure out
διανοέομαι	to intend (to do something), to think about/consider
διαπέμπω	send over
διαπονέω	practise hard, labour at
διαπορεύομαι	travel through, go through, go across
διαπρεπής, ες	particularly conspicuous
διαρπάζω	plunder
διαρρήγνυμι	break (through)
διαρρήδην	expressly
διασπαράσσω	rend in pieces
διασπάω	tear (asunder)
διασπείρω	scatter, spread about
διάστηµα	gap, distance
διασχίζω	cleave asunder
διασώζω	preserve; (pass.) arrive safely
διατελέω	continue
διατετραίνω	bore through
διατρίβω	spend one's time, live
διαφερόντως	especially, extremely
διαφέρω	differ, excel; (pass. quarrel, argue)
διαφεύγω	escape
διάφευξις	means of escape
διαφθείρω	destroy
διαφορὰ	difference, disagreement
διαφόρως	variously, in different ways, superiorly
διαφυλάσσω	maintain, preserve, conserve
διαχράοµαι	make away with, destroy, kill
διδάσκω	teach, inform, tell; (pass.) learn
διδράσκω	run
δίδωµι	give, offer
διέξειμι	recount
διεξέρχομαι	go through
διέρχομαι	pass through, cross
διηγέοµαι	describe in full, explain, relate in detail
διικνέοµαι	reach
διισχυρίζοµαι	be adamant, insist, stick to one's assertion
δικάζω	judge, give sentence
δίκαιος, α, ον	just, right
δίκαιός ειμι	I deserve/have a right to
δικανικός, ή, όν	legal, forensic
δικαστήριον	court, law-court
δικαστὴς	judge
δίκη	law(suit), case; compensation
δίκτυον	net
δίοδος	passage
διόπερ	wherefore, and therefore
διότι	since, why
διπλοῦς, ῆ, οῦν	twofold
δίς	twice, two times
δισμύριοι, αι, α	two thousand
δίψα	(noun) thirst
διψάω	be thirsty
διώκω	pursue, prosecute
ὁ διώκων	the prosecutor
δίωξις	pursuit
δοκέω	seem, seem good
δόλος	trick, treachery, cunning, guile
δόξα	opinion, reputation
δοράτιον	dart
δορυφόρος	guard, guardsman (of a king); (literally, 'lancer')
δουλεία	slavery
δοῦλος	slavery
δουλόω	enslave
δράκων	dragon, serpent
δραπέτης	runaway, fugitive
δράω	do
δρόμος	race(track), course, path
δροσερός, ά, όν	dewy
δύναμαι	be able, prevail
δυνατός ή, όν	powerful, able, possible
δύο	two
δύσις	setting (of the sun)
δύσκολος	discontented, ill-tempered
δυστυχἠς	unfortunate
δυσχεραίνω	be disgusted at
δυσχερής, ές	troublesome
δώδεκα	twelve
δωμάτιον	room
δωρέα/δῶρον	gift
δωρέομαι	(verb) present
δωροφορέω	bring presents
ἐάν	if
ἑαυτοῦ, ῆς, οῦ	of himself/herself/itself
ἐαω	allow
ἑβδομήκοντα	seventy
ἐγγράφω	inscribe, write on
ἐγγυς	near
ἐγκαθίστημι	set up in
ἐγκαλέω	complain against, indict
ἐγκαταλείπω	leave behind
ἔγκειμαι	press hard upon, attack
ἐγκρατής, ές	controlling, master of
ἐγκύπτω	step down and look into, peep into; look closely at
ἐγκωμιάζω	praise
ἐγρήγορα	be awake
ἐγχειρίδιον	dagger
ἐγώ	I
ἔγωγε	I for my part
ἔδεσμα	food
ἐθέλω	I want, I am willing
εἰ	if
εἶα	come on!, let's go!
εἶδος	form
εἰκάζω	portray, liken, compare; (pass.) take the form of
εἰκός	probable
εἴκοσι	twenty
εἰκότως	naturally
εἰρήνη	peace
εἰρηνικός	peaceable, peaceful
εἱρκτή	prison
εἰς	into, towards, in reference to, for
εἷς, μία, ἕν	one
εἰσαγγέλλω	impeach, denounce
εἰσάγω	lead into, introduce, bring before
εἰσβαίνω	go into, embark
εἰσβάλλω	throw into; invade
εἴσειμι	go into, enter
εἰσέρχομαι	enter
εἰσπέμπω	send in
εἰσπίπτω	fall in/on, throw oneself into/on, be thrown into
εἰστίθημι	put into
εἶτα	then, thereupon, afterwards
εἴωθα/εἰώθειν	be accustomed
τὸ εἰωθός	one's custom
ἐκ	out of, from
ἑκασταχοῦ	everywhere, under all circumstances
ἕκαστος, η, ον	each, every
καθ' ἑκάστην ἡμεραν	every day, daily
ἑκατόν	a hundred
ἐκβαίνω	go out, disembark, turn out (ie. prove to be)
ἐκβάλλω	cast out
ἐκβιβάζω	put on shore, make to disembark, land
ἐκδιδράσκω	escape
ἐκδίδωμι	give out, give away (in marriage)
ἐκεῖ	there
ἐκεῖθεν	from there
ἐκεῖνος	that, the other
ἐκεῖσε	to there
ἐκκλησία	assembly, gathering
ἐκκόπτω	cut off, cut down
ἐκκρούω	knock out
ἐκλέγω	pick out, choose
ἐκλείπω	come to an end
ἐκπηδάω	leap out
ἐκπλέω	sail out
ἔκπληξις	dismay, consternation
ἐκπλήσσω	astound, dismay
ἔκπλους	passage out; expedition
ἐκπρεπής, ές	preeminient
ἔκπυστος, ον	known
ἐκρήγνυμι	burst out
ἐκτείνω	stretch out
ἐκτρέφω	rear up
ἐκφέρω	carry out (for burial); bury
ἐκφορά	funeral
ἑκων, οῦσα, όν	willingly
ἔλαιον	oil
ἐλασσόω	lessen
ἐλάσσων	smaller, less
ἐλαύνω	drive
ἔλαφος	deer
ἐλεγεῖον	elegy
ἐλέγχω	refute, convict, prove
ἐλεεινός, ή, όν	pitiable, piteous
ἐλεέω	pity
ἐλευθερία	freedom
ἐλευθέριος, ον	liberal, generous
ἐλευθεριότης	liberality, freedom
ἐλεύθερος, α, ον	free, liberal
ἐλέφας	elephant
ἕλκω	drag
ἐλλοχάω	waylay
ἐλπίζω	hope, expect
ἐμαυτοῦ, ἐμαυτῆς	of myself, my own
ἐμβάλλω	throw in, inflict; attack
ἐμβιβάζω	put on broad
ἐμβολή	(noun) assault, attack, charge
ἐμέ	me
ἐμμένω	abide by
ἐμός, ή, όν	my, mine
ἐμπαλάσσω	entangle together
ἔμπειρος	skilful, experienced in
ἐμπίπλημι	fill, fulfill
ἐμπίπρημι	set on fire
ἐμπίπτω	fall upon, rush in
ἐμπλέω	sail in
οἱ εμπλέοντες	the crew
ἐμπορία	(noun) trade
ἐμπορικός, ή, όν	of or for commerce, mercantile
ἐμπόριον	market
ἔμπορος	merchant
ἔμπροσθεν	before, in front
ἐμφύω	implant
ἐν	in, at, upon, among
έναντίος, η, ον	opposite; opponent, adversary
ἐναντίως	contrariwise, contrarily
ἐνδεής, ές	deficient, defective, wanting in
ἐνδίδωμι	give in
ἔνδοθεν	from within
ἔνδον	within, inside
ἔνδοξος	in repute, distinguished
ἐνδύω	clothe; (mid/perf) put on, wear, be dressed
ἐνέδρα	(noun) ambush
ἔνειμι	to be in
ἕνεκα	on account of, as for
ἐνενήκοντα	ninety
ἐνέχω	hold fast, catch
ἔνθα	where
ἐνθάδε	here
ἐνιαυτός	year
ἔνιοι, αι, α	some
ἐννέα	nine
ἐνοικέω	dwell in, inhabit
ἐνοικοδομέω	build in
ἐνταῦθα	there
ἐντεῦθεν	from there
ἐντίθημι	put into
ἔντιμος, ον	honoured, distinguished
ἐντυγχάνω	chance upon, encounter; entreat, appeal, call upon
ἕξ	six
ἐξαγγέλλω	tell, report
ἐξάγω	lead out
ἐξαιρέω	take out
ἐξαίφνης	suddenly
ἐξαπατάω	thoroughly deceive
ἐξαπιναίως	suddenly
ἔξειμι	go out
ἐξέλκω	drag out, draw out
ἔξεστι	it is lawful, it is permissible, one may (do such and such)
ἐξετάζω	examine, sift
ἐξευρίσκω	invent, discover
ἐξέχω	project from, jut out of
ἐξήκοντα	sixty
ἔξω	outside
ἔοικα	seem, seem good
ὡς ἔοικε	as it appears
ἑορτή	festival
ἐπαγγέλλω	proclaim; (mid.) offer, promise
ἐπάγω	apply, bring to bear
ἐπαινέω	approve, recommend
ἔπαινος	praise, laudatory speech, recommendation
ἐπαιτέω	ask further
ἐπακολουθέω	follow after
ἐπαμύνω	assist
ἐπάνειμι	return, come up again
ἐπανέρχομαι	return
ἐπανίστημι	set up again; (pass.) stand up
ἐπεί	since, when
ἐπείγω	urge on, hasten
ἐπειδάν	whenever
ἐπειδή	when, since, after that
ἔπειμι (from εἶναι)	be upon
ἔπειμι (from ἰέναι)	follow
ἐπεῖπον	said besides, said in addition, added
ἔπειτα	thereupon, afterwards, then
ἐπελπίζω	raise one's hopes
ἐπέρχομαι	attack, come on
ἐπερωτάω	question
ἐπέχω	stop
ἐπί	(+dat.) for, at, on the strength of, besides; (+acc) to, on to, against, up to; (+gen) upon, towards, in the time of
ἐπιβαίνω	mount, ascend, go up on to
ἐπιβάλλω	throw at/upon; (fig.) oppose
ἐπιβάτης	passenger, marine
ἐπιβοηθέω	come to the rescue
ἐπιβουλεύω	plot against
ἐπιγίγνομαι	come on, follow
ἐπιγράφω	inscribe, write on
ἐπιδείκνυμι	prove, show
ἐπιδίδωμι	give besides
ἐπιδρομή	inroad, attack, foray
ἐπιείκεια	equitable conduct, moderation
ἐπιθαρσὐνω	cheer on
ἐπιθορυβέω	shout approval
ἐπιθυμέω	take a fancy to, desire, covet
ἐπιθυμία	desire, longing
ἐπικάθημαι	sit on, be mounted on
ἐπικαλέω	call upon, invoke; (mid.) call to aid, appeal to
ἐπίκειμαι	press hard upon
ἐπικίνδυνος, ον	hazardous, dangerous
ἐπίκλησις	additional name
ἐπίκουρος	auxiliary
ἐπικύπτω	stoop down
ἐπιλανθάνομαι	forget
ἐπίλεκτος, ον	chosen, picked
ἐπιλοιπος, ον	remaining
ἐπιμέλεια	(noun) care
ἐπιμελέομαι	take care of
ἐπιμελἠς, ἐς	careful
ἐπιμένω	wait for, abide
ἐπινοέω	intend
ἐπιορκέω	perjure oneself
ἐπιπίπτω	fall upon
ἐπιπλἐω	sail up, sail with
ἐπίπλους	attack, expedition
ἐπιρώννυμι	encourage
ἐπισκοπέω	inspect
ἐπισκώπτω	jeer, make fun of
ἐπισπάω	pull
ἐπίσταμαι	know, understand
ἐπιστήμη	knowledge, science, art
ἐπιστολή	letter
ἐπιστρατεύω	march against
ἐπιστρέφω	turn about
ἐπιτάσσω	enjoin, order
ἐπιταχύνω	urge forward
ἐπιτείνω	stretch, raise
ἐπιτειχίζω	build a fort against
ἐπιτελέω	accomplish, fulfil
ἐπιτήδειος, α, ον	fit, necessary; friendly
ἐπιτήδευμα	pursuit, vocation, calling
ἐπιτίθημι	put upon; (mid.) set upon, attack
ἐπιτιμάω	reproach, reprove
ἐπιτρέπω	entrust, permit
ἐπιτυγχάνω	light upon, meet with
ἐπιφαίνω	display; (mid./pass.) appear, present oneself
ἐπιφέρω	bring, apply, bring to bear; (pass.) rush upon, attack
ἐπίφορος, ον	carrying towards
ἐπιχειρέω	set to work, make an attempt, have a try at
ἐπιχέω	pour, pour on to
ἐπιχώριος, α, ον	native
ἔτοικος	settler, colonist
ἕπομαι	follow
ἔπος	word
ἐποτρύνω	stir up
ἑπτά	seven
ἑπτακόσιοι, αι, α	seven hundred
ἐργάζομαι	work at
ἐργασία	business
ἔργον	(noun) work
ἐρευνάω	search
ἐρημία	wilderness
ἔρημος	lonely
ἔρις	contention, strife
ἔρομαι	ask
ἐρυθριάω	blush
ἔρυμα	fort
ἔρχομαι	come, go
ἐρωτάω	ask
ἑσθής	dress, clothes
ἐσθίω	eat
ἑσπέρα	evening
ἑστία	hearth
ἑστίασις	entertainment
ἑστιάω	to entertain
ἔσω	inside, within
ἑταῖρος	companion, comrade
ἔτερος, α, ον	different, other, the other
ἔτι	still, yet, moreover
ἑτοιμάζω	make ready, prepare
ἑτοῖμος, η, ον	ready, prepared
ἔτος	year
εὖ	well
εὐγενής, ές	well-born, noble, generous
εὐγνώμων, ον	kind, sensible
εὐδαιμονία	happiness
εύδαίμων	prosperous
εὐδόκιμος	highly esteemed
εὐειδής, ές	fair, graceful
εὐεργεσία	service, kindness, benefit
εὐεργετέω	benefit
εὐεργέτης	benefactor
εὐήθης, ες	silly, foolish
εὔθυμος, ον	cheerful
εὐθύς	immediately, straight away, right towards
εὔκοσμος, ον	in good order, orderly
εὐνή	bed
εὔνοια	goodwill
εὔνους, ουν	well-disposed, affectionate
εὑρίσκω	find; (mid.) procure
εὔστροφος, ον	nimble
εὐσχήμων, ον	graceful, good-looking
εὐτέλεια	economy (as in cheap, low cost, eg. 'economy flights)
εὐτέλης, ες	cheap
εὐτελῶς	cheaply
εὔτολμος	courageous
εὐτύχημα	piece of good luck, success
εὐτυχία	good luck
εὔχομαι	pray, boast oneself, profess to
εὐωδία	fragrance
εὐώνυμος, ον	left hand, left
ἔφηβος, ον	grown up, a young man
ἐφίημι	shoot, launch at
ἐφικνέομαι	come up to, reach
ἐφίστημι	set over, halt
ἔφοδος	access, approach, attack
ἔφορος	overseer, surveyor, guardian
ἔχθρός, ά, όν	hostile; enemy
ἔχω	have, possess, keep, be able to
ἕως	(1) daybreak, dawn. (2) until, as long as, up to
ζάω	live
ζεῦγμα	something used for joining; a bridge of boats; canal lock
ζέφυρος	west wind
ζημία	penalty
ζημιόω	punish, fine
ζητέω	seek
ζήτησις	search, investigation
ζωγράφημα	painting
ζωγράφος	painter
ζωγρέω	capture, take alive
ζωμός	broth
ζῷον	animal, beast, living creature
ἢ	either, or than
ᾗ	as, how, in what way
ἡβάω	be grown up, be at one's prime
ἡγεμών	leader, guide
ἡγέομαι	lead; hold, consider
ἡδέως	gladly, pleasantly
ἤδη	already
ἥδομαι	enjoy, be pleased
ἡδονή	delight, pleasure
ἡδύς, εῖα, ύ	pleasant, agreeable
ἦθος	habit, character
ἥκω	I have come, am present
ἠλίθιος, α, ον	silly
ἡλικία	prime of life, full vigour
ἡλικιώτης	equal in age, contemporary
ἥλιος	sun
ἡμερα	day
ἥμερος, α, ον	tame, gentle
ἡμέτερος, α, ον	our, ours
ἥμισυς	halt
ἢν	= ἐάν, if
ἡνίκα	when
ἧπαρ	liver
ἤπειρος	mainland; joined to the mainland
ἧπερ	just as
ἡρωικός, ή, όν	heroic
ἡρῷον	shrine (of a hero)
ἥρως	hero
ἥσσων, ον	weaker, lesser
ἦσσον	(adverb) less
ἡσυχάζω	keep quiet, rest
ἡσυχῆ	quietly
ἡσυχία	quiet, rest
θάλασσα	sea
θαλάσσιος, α, ον	marine, naval
θάνατος	death
θανατόω	put to death
θάπτω	bury
θαρσἐω	take courage
θαρσύνω	encourage
θᾶσσον	more quickly (adverb)
θάσσων, ον	quicker (adjective)
θαῦμα	(noun) a wonder
θαυμάζω	wonder, marvel at, admire
θαυμάσιος, α, ον	wonderful, marvellous (also θαυμαστός, ή, όν)
θαυμασίως	wonderfully
θέα	spectacle
θέαμα	sight, spectacle
θεάομαι	see, behold, look at
θεατής	spectator
θέατρον	theatre
θεῖος, α, ον	divine, supernature
θεομαχία	combat of gods
θεός	god(dess)
θεραπεύω	serve, attend to
θεράπων	attendant
θέρος	summer
θέω	run
θήγω	whet, sharpen
θήρα	hunting, the chase
θηράω	to hunt, chase (also θηρεύω)
θηρευτής	hunter
θηρίον	beast, wild animal
θηριώδης, ες	beast-like, savage
θησαυρός	treasury
θητεύω	serve (for hire)
θνήσκω	die
θνητός, ή, όν	mortal
θορυβέω	to clamour, make an uproar
θόρυβος	confusion, uproar
θρασύνω	encourage
θραύω	break
θρίξ	hair (genitive τριχος)
θρόνος	chair, throne
θυγάτηρ	daughter
θυμίαμα	incense, spice
θυμιατήριον	censer
θυμοειδής, ές	passionate
θυμόω	make angry
θύρα	door
θυρίς	window
θυσία	sacrifice
θύω	sacrifice, offer
θώμιγξ	string, cord
θώραξ	breastplate, cuirass
ἰαομαι	cure, remedy
ἰατρικός	medical
ἰδέα	form
ἴδιος, α, ον	one's own; private
ἰδιώτης	private person
ἰδού	see! lo!
ἱδρύω	settle; (mid.) set up; (pass.) be placed, situated
ἱερεύς	priest
ἱερόν	temple, sanctuary
ἱερός, ά, όν	sacred
ἱερόσυλος, ον	sacrilegious, guilty of sacrilege
ἵημι	send, discharge
ἱκανος	sufficient, considerable
ἱκανῶς	sufficiently
ἱκέτης	suppliant
ἱκνέομαι	come
ἱμάτιον	clothes
ἵνα	so that, in order that; (adv.) where
ἱππεύς	horseman; (plural) cavalry
ἵππος	horse
ἰσθμός	isthmus
ἰσόρροπος, ον	equally balanced, even
ἴσος, η, ον	equal
ἵστημι	set, place, set up; (passive) stand, stand up, be set up
ἱστορέω	question
ἱστος	mast (of a ship)
ἰσχυρός, ά, όν	strong, mighty; violent, severe
ἰσχύς	strength
ἴσως	equally; perhaps
ἰχυθοπώλης	fishmonger
ἰχθύς	fish
καθαιρέω	remove, destroy
καθάπερ	just as, as, as if
καθέζομαι	sit down
καθείργω	shut up
καθέλκω	draw down, launch
κάθημαι	sit, be seated; lie in wait
καθιδρύω	settle, found
καθιερόω	consecrate
καθίζω	sit down, sit
καθίημι	let down, drive into
καθίστημι	appoint, establish
κάθοδος	opportunity of returning
καθοράω	observe, notice
καθυβρίζω	insult
καινός, ή, όν	new, recent
καίπερ	though
καίριος, α, ον	seasonable, timely, suitable
καιρός	time, the right time, the nick of time
καίω	burn, kindle, set on fire; (pass.) be on fire, burn
κακοπαθέω	suffer ill
κακός, ή, όν	bad, evil; abusive
κακοῦργος, ον	wicked; a criminal
κάλαμος	reed
καλέω	call, invite, name
καλινδέομαι	roll, tumble
καλλίπαις	blessed with beautiful children
κάλλιστος, η, ον	superlative of καλός
καλλίων	comparative of καλός
κάλλος	beauty
καλλωπίζω	smarten up, improve the appearance of
καλός, ή, όν	beautiful, fine, good
καλύβη	hut, cottage
καλῶς	well
κάμνω	be tired
καπηλεύω	retail, sell by retail
κάπηλος	pedlar, retail dealer
καρίς	prawn
καρκίνος	crab
καρπός	fruit
καρτερέω	hold out, bear up
καρτερός, ή, όν	strong, steadfast, obstinate
καρτερῶς	stoutly, vigorously
κατά	(+gen) down from/on, against; (+acc) along, by, according to, concerning
καταβαίνω	descend
καταβάλλω	throw down
καταβιβάζω	bring down
καταγέλαστος, ον	ridiculous
καταγελάω	mock, laugh down, ridicule
καταγηράσκω	grow old
καταγιγνώσκω	pass sentence upon, condemn
καταδικάζω	condemn
καταδουλόω	enslave
καταδύω	sink; disable (a ship)
καταθραύω	shatter, smash
κατακαίω	burn down, consume
κατάκειμαι	lie (down)
κατακλείω	shut up
κατακλίνομαι	lie down, recline
κατακόπτω	chop up, cut down
κατακρίνω	condemn
καταλαμβάνω	seize, catch
καταλάμπω	shine upon
καταλείπω	leave (behind)
κατάλογος	list, muster-roll
καταλύω	make an end of, halt; lodge
κατανοέω	perceive
καταπατέω	trample down
καταπαύω	stop
καταπηδάω	leap down
καταπίνω	drink down, swallow
καταπίπτω	fall down, sink
καταπλέω	sail (back)
κατάρα	(noun) curse
καταράομαι	I curse
κατασκευάζω	prepare
κατάσκοπος, ον	spying; a spy
κατασπείρω	spread abroad
καταστρέφω	subdue
κατασφαγίζω	seal up
κατατήκω	dissolve, melt
κατατίθημι	lay down
κατατοξεύω	shoot down
κατατραυματίζω	cover with wounds
καταφεύγω	flee
καταφρονέω	despise
καταφρονητέον	something that must be despised
καταχαλκόω	cover with brass
καταχέω	pour down, pour over
καταχώννυμι	overwhelm, bury
καταψηφίζομαι	vote guilty of
κάτειμι	go down, come down, return
κατέρχομαι	go down
κατεσθίω	eat up, devour
κατέχω	keep, occupy, seize, hold, restrain, take
κατηγορέω	accuse (someone of something)
κατηγορία	accusation
κατήγορος	accuser
κατοικίζω	set up, establish
κάτω	down
κάτωθε(ν)	from below
τὸ κάτωθε(ν)	the bottom
κατωτέρω	lower
καυλὀς	stem, stalk, shaft
καυχάομαι	boast in oneself
κέδρος	cedar
κεῖμαι	lie (down), lie sleeping
κελευστής	boatswain (naval term)
κελεύω	bid, command
κενός, ή, όν	empty
κεντέω	goad
κεραμεύς	potter
κεράμιον	jar
κέραμος	tiles
κεράννυμι	mix
κέρας	horn; wing (of an army or fleet)
κερασφόρος, ον	horned
κερδαίνω	gain
κέρδος	profit
κεφαλή	head
κῆπος	garden
κήρυγμα	proclamation
κῆρυξ	crier, herald
κηρύσσω	make proclamation, announce
κιθάρα	harp
κιθαρῳδός	harper
κιθαρίζω	play the harp
κινδυνεύω	run a risk
κίνδυνος	risk
κινέω	move
κίνησις	motion, gesture, movement
κισσός	ivy
κίστη	box, chest
κλάδος	branch
κλαίω	weep
κλέπτω	steal
κλῇθρον	bar
κληρονομία	inheritance
κληρονόμος	heir
κλῇσις	barrier
κλῇω	shut, close
κλίνη	bed, couch, bier
κλίνω	incline; (pass.) lie
κλοπή	theft
κοιλία	belly
κοῖλος	hollow
κοινῇ	in common, between them (adverb)
κοινός, ή, όν	common
τὸ κοινόν	the commonwealth; the public treasury
κοινωνέω	share
κοινωνός	sharer, associate
κολάζω	punish
κολακεία	flattery
κολακεύω	flatter
κόλαξ	flaterer
κόλασις	punishment, correction
κόλπος	bosom, lap; bay, creek
κολυμβάω	dive
κόμη	hair
κομίζω	bring, carry; (mid.) get; (pass.) journey
κόπος	fatigue, toil
κόπτω	cut; knock at (a door)
κόραξ	crow
κοσμέω	arrange, adorn
κόσμος	order, honour, credit
κοτύλη	anything hollow, a small cup; a liquid measure (approx. 1/2 a pint)
κράνος	helmet
κρατέω	seize, become master of, conquer
κρατήρ	large bowl (for wine)
κράτιστος, η, ον	best, strongest
κράτος	strength, force
κραυγή	clamour
κρείσσων, ον	stronger, better, superior
κρεμάννυμι	hang up
κρημνός	crag, cliff
κρημνώδης, ες	steep
κρίνω	judge, determine
κρίσις	judgement, trial
κρούω	beat
κρύβδην	secretly
κρυπτέυω	hide oneself
κρυπτός, ή, όν	hidden
κρύπτω	hide; (mid.) sheath one's sword
κρύσταλλος	ice
κρύφα	without the knowledge of
κτάομαι	gain; (perf.) possess, have, own
κτείνω	kill
κτῆμα	possession
κτίζω	found, build
κτύπος	noise
κύαθος	cup; small liquid measure
κυβερνάω	steer (a ship, etc)
κυβερνήτης	captain, pilot, navigator
κύκλῳ	round about
κυκλόω	surround
κύκνος	swan
κύλιξ	cup; small liquid measure
κυνίδιον	little dog
κυπαρίσσινος, η, ον	of cypress-wood
κύριος	lord, master
κύων	dog
κώδων	belly
κωλύω	hinder
κώνειον	hemlock (poison)
κώπη	oar
λαγχάνω	obtain (by lot)
λαγώς	hare, rabbit
λάθρᾳ	by stealth, secretly, without the knowledge of
λαιμαργία	voracity, greediness
λαλέω	talk
λαμβάνω	take, catch, get, receive
λαμπρός, ά, όν	splendid, brilliant, bright
λαμπρύνομαι	pride oneself, boast
λαμπρῶς	brilliantly
λανθάνω	escape notice, avoid detection
λάρναξ	chest, coffin
λάχανον	cabbage
λέγω	speak, say
λεία	booty, spoils
λείμων	meadow
λείπω	leave; come short of
λειτουργία	public service
λέξις	speech, style, language
λέπας	crag, cliff
λεπτός, ή, όν	slender, slight, small
λέσχη	conversation, talk, discussion
λευκός, ή, όν	white
λἐων	lion
λῄζομαι	plunder, ravage
ληρέω	talk nonsense, prate
λῃστεία	piracy
λῄστης	robber, pirate
λῃστρικός, ή, όν	piratical
ἡ λῃστρική	piracy
λίαν	too, too much, excessively
λίθινος, ή, όν	made of stone
λίθος	stone
λιθοτομία	stone-quarry
λιμήν	harbour
λιμός	famine, hunger
λιποψυχέω	faint
λογίζομαι	calculate, reckon
λογογράφος	historian, logographer
λόγος	word, talk, story, rumour, pretence, speech
λόγχη	lance, spear
λοιδορέω	abuse, revile, rail
λοιδορία	railing, abuse
λοιπός, ή, όν	rest, remaining, remainder
το λοιπόν	for the future
λόφος	hill
λυγίζομαι	writhe, wriggle
λυμαίνομαι	ravage, spoil
λυπέω	pain, vex, distress; (pass.) be in pain
λύπη	pain
λύσις	loosing, releasing, deliverance, solution (to a problem)
λυσιτελέω	profit, it'd be better for you to...
λύω	loose, set free; break up, dissolve
μὰ	particle used in oaths, eg. μὰ Δία, by Zeus!
μάγειρος	cook
μαίνομαι	be mad, be driven mad
μάκαρες	the blessed/righteous dead
μακάριος	happy, blessed
μακαρίως	happily
μακρός, ά, όν	long, far
μάλα	very
μαλακός, ή, όν	soft, weak, effeminate
μάλη	arm
μάλιστα	most, especially
μᾶλλον	more
μανθάνω	learn, discover
μανία	madness
μαντεῖον	shrine (of an oracle)
μάντις	prophet
μαρτύριον	proof
μαρτύρομαι	call to witness
μάρτυς	witness
μαστιγοφόρος	carrying whips
μάτην	in vain, vainly
μάχαιρα	knife, sword
μάχη	battle, quarrel, strife, fighting
μάχομαι	fight, do battle
μεγαλαυχέω	boast
μεγαλοπρεπής, ές	magnificent, splendid
μεγαλύνομαι	exalt oneself, give oneself airs
μέγας, μεγάλη, μέγα	great, large, big
μέγεθος	greatness, size
μέθη	drinking, drunkenness
μεθίημι	let go, let loose, drop
μεθίστημι	remove, change, alter
μεθύσκω	intoxicate
μειδιάω	smile
μείζων	greater
μέλας, μέλαινα, μέλαν	black
μελετάω	study
μέλλω	be about to, intend, be likely to
μέλος	limb
μέλω	(impersonal) matter, signify, be a care to
μελήσει αὐτῳ	he will see to it
μὲν	comparative particle, on the one hand...
ἔγω μὲν	I for my part
μένω	remain
μέντοι	however
μέρος	part, share
μεσογεία	interior (of a country)
μέσος, η, ον	in the middle of, midway between, in the midst of
διὰ μέσου	between
μετὰ	(gen.) with, along with; (acc.) after
μεταβάλλω	change
μεταδίδωμι	give a share
μεταλλάσσω	change
μέταλλον	mine
μεταμέλομαι	repent, regret, be sorry for
μετάνοια	repentance
μεταξύ	(of space) between; (of time) during, meanwhile
μεταπέμπω	send for, send after
μεταπλάσσω	convert
μετάστασις	departure
μεταστρέφω	turn round
μεταχειρίζω	handle, treat
μετέχω	partake, share
μετέωρος, ον	high, on high; out to sea
μέτριος, α, ον	moderate
μέτρον	measure
μέτωπον	front; forehead
μέχρι	until, up to, as far as
μὴ	not, lest
μηδαμῶς	by no means
μηδὲ	neither, nor, not even, and not
μηδείς, μηδεμία, μηδέν	none, no, no-one
μηκέτι	no longer
μῆκος	length
μηκύνω	prolong
μῆλον	apple, fruit
μὴν	indeed, yet
μὴν (gen. μηνός)	month
μηνύω	make known, inform, denounce
μήποτε	never, lest ever
μήτε	neither, nor
μήτηρ	mother
μηχανάομαι	contrive, devise
μηχανή	device, plan
μία	one (f.)
μιαίνω	soil, stain
μιαιφονία	bloodthirsty, cruelty
μιαρός, ά, όν	dirty, disgusting, abominable
μικρός, ά, όν	small, little (also σμικρός, ά, όν)
μικρότης	littleness, smallness
μιμέομαι	mimic, imitate
μιμνήσκω	remind; (pass.) remember
μισέω	hate
μισθαρνέω	work for hire
μισθός	reward, pay
μισθόω	let; (mid.) hire
μνῆμα	monument
μνημεῖον	memorial
μνημονεύω	remember, record
μνηστεύω	court, woo
μονομαχέω	fight (in single combat), duel
μόνος, η, ον	alone, only
μονόω	leave alone
μορφή	shape, form
μόσχος	calf
μουσική	music, poetry
μυθολόγος	story-teller, narrator of myths
μῦθος	story, myth
μυκτῆρ	snout
μυριάς	myriad (ie. 10,000)
μυρίος, α, ον	numberless, infinite; (plural.) ten thousands
μυρσίνη	myrtle
μῦς	mouse
μυχός	corner
μύω	keep one's eyes shut
μωρός, ά, όν	foolish; a fool
ναί	yes
ναός	temple (also νεώς)
νάρθηξ	fennel-stalk
ναυαγία	shipwreck
ναυάγιον	wreckage, wreck
ναύαρχος	admiral
ναυκρατέω	have mastery at sea
ναυμαχέω	fight (by sea)
ναυμαχία	sea battle
ναῦς	ship
ναύτης	sailor
ναυτικός, ή, όν	naval
νεαλής, ές	fresh
νεανίσκος	youth, young man
νεκρός	dead body, corpse
νέμω	allot, feed flocks; (mid.) graze
νεογενής, ές	newborn
νέος, α, ον	young, new
νεοσσός	young (of birds)
νέω	(1) swim; (2) heap up, rear
νεωστί	recently
νεωτερίζω	to innovate, to make revolutionary movements
νεώτερος	newer, younger
νὴ	oath particle (eg. νὴ τὸν Δία!, by Zeus!)
νησιώτης	islander
νῆσος	island
νήφω	be sober
νικάω	conquer, win, have victory
νίκη	victory
νοέω	notice
νομή	pasture
νομίζω	consider, hold
νομοθεσία	law-making, legislation
νομοθέτης	law-giver
νόμος	custom, law
νοσέω	be sick, fall ill
νόσος	disease, sickness
νότος	south wind
νουθετέω	admonish
νοῦς	mind
νύκτωρ	by night
νύμφη	bride
νῦν	now
νύξ	night
νυός	daughter-in-law
νῶτον	(noun) back; rear part of body
ξενίζω	entertain (guests)
ξένισις	entertainment
ξένος	stranger, friend, guest, host
ξηραίνω	dry up, drain off
ξηρός	dry; dry land
ξίφος	sword
ξύλινος	of wood, wooden
ξύλον	wood, timber
ὀβολός	obol (small coin)
ὅδε, ἥδε, τόδε	this here, this
ὁδοποιέομαι	advance, move forward, go
ὁδός	way, road
ὀδούς	tooth, tusk
ὀδύρομαι	lament, complain
ὄζος	brance
ὅθεν	from where, whence
οἶ	to where, whither
οἶδα	I know (perfect form w/ present meaning)
οἴκαδε	(adverb) to home, homeward
οἰκεῖος, α, ον	one's own; friends, relations
οἰκέτης	slave, domestic
οἰκέω	dwell, inhabit
οἴκημα	house
οἴκησις	dwelling
οἰκήτωρ	settler, inhabitant
οἰκία	house
οἰκίζω	colonise
οἰκίσκος	room
οἰσκιστής	coloniser, founder (of a colony)
οἰκοδομέω	build
οἴκοθεν	from home
οἴκοι	at home (also καθ' οἰκον)
οἶκος	house
οἰκτείρω	pity
οἶμαι	think (also οἴομαι)
οἶνος	wine
οἶος, α, ον	what (kind of)
οἰστός	arrow
οἴχομαι	be off, be gone, make oneself scarce
ὀκέλλω	run ashore
ὄλεθρος	destruction, ruin
ὀλιγαρχικός, ή, όν	oligarchic; pertaining to an oligarchy
ὀλίγος, η, ον	few, little
ὀλιγωρία	(noun) scorn, a light estimation (of something)
ὄλλυμι	destroy
ὅλος, η, ον	whole
ὀλοφυρμός	lamentation
ὀλοφύρομαι	lament
ὅλως	altogether
ὄμβρος	rain, shower, rain-storm
ὅμηρος	hostage
ὁμιλέω	associate with
ὅμιλος	multitude
ὀμνύω	swear
ὁμόθεν	from/at the same place; (figuratively) at close quarters, hand-to-hand
ὅμοιος, α, ον	like, equal
ὁμοίως	alike, similarly
ὁμολογέω	agree
ὁμολογία	agreement
ὅμορος, ον	neighbouring, next
ὁμοῦ	at once, together
ὁμόφυλος, ον	of the same tribe; common nationality
ὅμως	nevertheless
ὀνειδίζω	reproach, revile
ὀνηλάτης	driver (of a donkey)
ὄνομα	name
ὀνομάζω	call, name
ὄνος	donkey
ὄντως	really
ὀξύς, εῖα, ύ	sharp; hasty
ὅπη	in what way
ὄπισθε(ν)	(from) behind, rear, back
ὁπλίζω	arm, equip
ὅπλισις	equipment
ὁπλίτης	hoplite
ὅπλον	arms, armour
ὁπόθεν	from where, whence
ὅποι	to where, whither
ὁποῖος, α, ον	what kind
ὁπότε	when(ever)
ὁπότερος, α, ον	which (of two)
ὅπου	where
ὁπώρα	autumn
ὅπως	how, so that, that
ὁπωσοῦν	at all
ὁράω	see, look
ὀργή	anger, rage, passion
ὀργίζω	enrage, provoke
ὄργυια	fathom (ie. 6 feet, 1.82m)
ὀρέγω	stretch; (mid.) reach at, reach after
ὀρθός, ή, όν	straight, upright
ὄρθρος	morning, early dawn
ὀρθῶς	rightly
ὅρκος	oath
ὁρμάω	urge on; (mid.) rush, start off
ὁρμή	impulse, rush, attack
ὁρμιζω	moor, anchor
ὀρνιθεύω	snare birds, fowl
ὄρνις	bird
ὄρος	mountain
ὅρος	frontier, boundary
ὀροφή	roof, ceiling
ὅς, ἥ, ὅ	who, which, what; he/she/it
ὅσος, η, ον	as much as, as many as
ὅσπερ, ἥπερ, ὅπερ	who, which
ὅστις, ἥτις, ὅ τι	who(ever), which(ever)
ὀστοῦν	bone
ὅταν	whenever
ὅτε	when
ὅτι	that
ὅ τι τάχιστα	as quickly as possible
ὁτιοῦν	at all
οὐδ' ὁτιοῦν	not at all, not a bit
οὐ	no, not
οὖ	where
οὐδαμόθεν	from no place, from no side
οὐδαμοῦ	nowhere
οὐδὲ	neither...nor, and not
οὺδεὶς, οὐδεμία, οὐδὲν	none, no one, nothing
οὐδέποτε	never
οὐδεπώποτε	never yet
οὐδέτερος, α, ον	neither (of two)
οὐκέτι	no longer
οὐκοῦν	therefore, accordingly
οὖν	then, therefore
οὔπω	not yet
οὐρά	tail
οὐρανός	sky, heaven
οὐσία	property, substance
οὔτε	neither, nor
οὖτος, αὕτη, τοῦτο	this
ὦ οὗτος	contemptuous form of address
οὕτω(ς)	so, thus, like this
ὀφείλω	owe
ὀφθαλμός	eye
ὄφις	serpent, snake
ὀφλισκάνω	lose (a lawsuit)
ὄχλος	mob, crowd
οψέ	late (adv.)
ὄψιος, α, ον	late (adj.)
ὄψις	face, look
ὄψον	cooked meat; a delicacy
πάγη	snare
πάθος	suffering, misfortune
παιδεύω	bring up, train
παιδίον	child
παιδοποιέομαι	beget children
παίζω	play, sport
παῖς	boy, child
παίω	strike, hit, smite
παιωνίζω	sing the Paean (battle hymn)
πάλαι	of old, long ago
παλαιός, ά, όν	old
παλαίστρα	wrestling school
πάλιν	back, again
παλίρροια	falling tide
πανδημεί	en masse, with the whole people
πανδοκεῖον	inn, public house
πανήγυρις	festival
πανόπτης	all-seeing
πανοῦργος	rascal, rogue
πανταχόθεν	from everywhere, from all sides
πανταχοῦ	everywhere
παντοῖος, α, ον	of all sorts
πάντως	by all means
πάνυ	very, at all
πάππος	grandfather
παρὰ	(gen.) from; (dat.) besides, with, by; (acc.) along, to, beyond
παραβαίνω	transgress
παραβλέπω	take a side look, peep
παραβοηθέω	come to the rescue of
παραγίγνομαι	arrive, present onself, appear
παράδεισος	park, garden
παραδίδωμι	hand over, surrender
παράδοξος, ον	unexpected, startling
παραινέω	advise
παραίρημα	(noun) a strip (of something)
παραιτέομαι	beg off, deprecate
παρακάθημαι	sit beside
παρακαλέω	invite
παράκειμαι	lie beside, lie by
παρακελεύω	exhort, encourage
παραλαμβάνω	receive from another
παραλείπω	omit, pass over
παραλία	sea-coast, beach
παραμένω	stay with, stay beside
παραμυθέομαι	address with cheering words, comfort
παρανομέω	transgress the law
παράνομος, ον	illegal
παράπαν	at all
παραπλέω	sail past
παραπλήσιος, ον	nearly resembling, nearly equal, about equal
παρασάγγης	measure of distance (30 stadia; 3.4 miles; 5.4km)
παρασιτέω	dine with
παρασκευάζω	prepare
παρασκευή	arrangement, preparation, pomp
παρατάσσω	draw up in line
παρατίθημι	place beside
παρατρέπω	turn aside, divert
πάρειμι	be present; (impersonal) one may
παρεκκλίνω	turn a little aside
παρέρχομαι	come forward
παρέχω	furnish, offer, cause
παρθένος	maiden, virgin
παριππεύω	run alongside
παροιμία	proverb
παροξύνω	urge on
πᾶς, πᾶσα, πᾶν	all, whole, every
πάσχω	suffer, be treated (ill/well), experience
πατάσσω	beat, strike
πατήρ	father
πάτριος, α, ον	national, ancestral
πατρίς	fatherland
πατρῷος, α, ον	paternal
παύω	stop, cease, close; (mid/pass), leave off
παχύς, εῖα, ύ	stout, thick, large fat
πεδίον	plain
πεζός, ή, όν	foot, infantry
πεζῇ	by land
πειθαρχέω	obey
πείθω	persuade, convince; (mid/pass) obey, agree, comply
πεινάω	be hungry
πεῖρα	attempt, experiment
πειράομαι	attempt, try
πελάγιος, α, ον	marine, from the sea
πέλας	near
οἱ πέλας	one's neighbours
πέλω	be, become, be in motion
πέμπτος, η, ον	fifth
πέμπω	send
πένης	poor
πενία	poverty
πεντακόσιοι, αι, α	five hundred
πέντε	five
πεντήκοντα	fifty
περαιόω	convey across; (pass.) pass over, cross
περὶ	(gen.) about, concerning; (dat.) about; (acc.) about, round about
περιάγω	bring round, twist round
περιαιρέω	take away, strip off
περιβάλλω	encompass, surrount; (mid.) put on (a dress, etc).
περιβραχιόνιον	armlet
περιγίγνομαι	prevail, survive
περιδεής, ές	greatly frightened, in great fear
περίειμι	surround, encompass
περιέρχομαι	come around
περιέχω	encompass
περιίστημι	place round, stand around, encircle
περιλαμβάνω	encompass, catch
περιμένω	wait
περιοράω	disregard, put up with, overlook
περιπατέω	walk about
περιπέμπω	send round
περιπήγνυμι	fix round
περιπίπτω	fall in with
περιπλέω	sail round
περιρρέω	flow round
περισκοπέω	look round
περισσεύω	abound
περισσός, ή, όν	more than, enough, excessive
περιστερά	pigeon, dove
περιφέρω	carry about
περιφόβος, ον	exceedingly terrified
περιχαρής, ές	exceedingly glad
πέτομαι	fly
πέτρα	rock
πη	in some way, in any way
πήγνυμι	fix
πηδάω	spring, leap
πῆχυς	cubit
πιέζω	crush, press, oppress, press hard upon
πιθανός, ή, όν	persuasive, plausible
πίθηκος	monkey
πίθος	wine jar
πῖλος	felt, felt cap, felt cuirass
πίμπλημι	fill, fulfill
πίμπρημι	burn, set on fire
πίναξ	tablet, ie. wax writing tablet
πίνω	drink
πίπτω	fall
πιστεύω	believe
πιστός, ή, όν	faithful, trusty
πίτυς	pine-tree
πλανάω	mislead: (mid./pass.) stray, wander
πλάσσω	mould, make up
πλάτος	breadth
πλεῖστος, η, ον	most; for the most part
πλεονέκτης, ες	covetous, greedy
πλέω	sail
πλέων, ον	more
πληγή	blow
πλῆθος	crowd, number, quantity, amount
πλήν	except
πλήρης, ες	full (of)
πληρόω	fill; man (a ship)
πλησιάζω	approach
πλησίος	neighbour
πλησίον	near
πλήσσω	strike, wound
πλοῖον	vessel, boat
πλοῦς	voyage
πλούσιος, α, ον	rich
πλοῦτος	wealth
πνεῦμα	wind, breath
πνέω	breathe
πνῖγος	heat
πνίγω	stifle, choke
πόθεν	from where?; from somewhere
ποῖ	to where?; to somewhere
ποιέω	do, make; (mid.) make for oneself, hold, consider
ποίημα	poem
ποίησις	poetry
ποιητής	poet
ποιμήν	shepherd
ποίμνιον	flock
ποῖος, α, ον	what kind?
πολεμικός, ή, όν	warlike
πολέμιος, α, ον	an enemy
πόλεμος	war
πολιορκέω	beseige
πολιορκία	siege
πόλις	city, state
πολιτεία	constitution
πολίτης	citizen, fellow citizen
πολιτικός, ή, όν	public, civic
τὰ πολιτικά	state affairs
πολλάκις	often, many times
πολλαπλάσιος, α, ον	many times more
πολυδάπανος, ον	extravagant
πολυειδής, ές	various
 πολυπραγμονέω	meddle
πολύς, πολλή, πολύ	many, much
πολυτελής, ές	costly
πονηρός, ά, όν	wicked, evil
πονηρῶς	dishonourably, wickedly, in a bad state
πόνος	toil, labour
πορεία	journey
πορεύω	convey; (mid./pass.) go, travel
πορθέω	ravage
πορίζω	furnish; (mid.) procure, provide
πόρος	ford, passage
πόρρω	(adv.) far
πορφυροῦς, ᾶ, οῦν	purple, red
πόσις	drinking
πόσος	how much?
ποταμός	river
πότε	when?; once, ever
πότερος, α, ον	which (of two)
πότερον...ἤ	whether...or
ποτήριον	cup
πότος	drinking
ποῦ	where? (που = anywhere)
πουλύπους	octopus, cuttlefish; (lit.) many-feet
ποῦς	foot
πρᾶγμα	deed, thing, affair
πραγματεία	occupation, business
πραγματεύομαι	busy oneself about
πρᾶος, πρᾶον	gentle, meek, mild (also πραΰς, εῖα, ύ)
πράσσω	do, fare
πρέπω	be suitable, become, be proper
πρεσβεις	ambassadors
πρεσβύτης	old man
πρὶν	before; the past
πρὸ	before, for
προάστειον	suburb
προβαίνω	go on, advance
προβοσκίς	trunk (of an elephant)
προβουλεύω	contrive measures beforehand, debate or consider first
προγίγνομαι	happen before, be born first
προδιδάσκω	teach beforehand
προδίδωμι	betray
προδοσία	treason
πρόειμι	advance
προεξανάγω	put out to sea before
προεξέρχομαι	go out before
προέρχομαι	advance
προέχω	be superior
προθυμέομαι	be eager
προθυμία	zeal
πρόθυμος, ον	eager
προθύμως	readily
προίστημι	set before; (mid/pass) be at the head of
προκαλέομαι	challenge
προκαταλαμβάνω	sieze beforehand, anticipate, preclude
προκαταφεύγω	escape before
προλαμβάνω	get on ahead
προλείπω	fall short, fail
προπηδάω	spring forward
προπηλακίζω	abuse, treat with indignity
πρὸς	(gen.) from, by; (dat.) at, to, besides; (acc.) to(wards) in regard to, upon, with
προσάπτω	fasten to
προσβάλλω	attack
προσβολή	attack, assault
προσδέομαι	want
προσδέχομαι	accept, expect
προσδοκάω	expect
προσεδρεία	besieging, siege
πρόσειμι	approach, advance
προσεῖπον	(aorist only) address, accost
προσελαύνω	ride on/forward, ride before
προσέρχομαι	approach
προσήκω	belong to, concern
τὸ προσῆκον	one's due
προσηλόω	nail to
πρόσθεν	before, forwards, the front
προσκαθέζομαι	besiege, beleaguer (lit. sit down before)
προσκαλέω	summon, call
προσκεῖμαι	devote oneself to, be fond of
προσκεφάλαιον	cushion, pillow
προσκολλάω	stick to
προσκομίζω	bring
προσκυνέω	prostrate oneself, do obesiance to
προσμίσγω	come in contact with
προσνέω	swim towards
πρόσοδος	revenue
προσορμίζομαι	come to anchor near
προσπελάζω	approach
προπίπτω	attack, fall down
προσπλέω	sail up, sail towards
προσποιοῦμαι	claim, pretend
προστάσσω	enjoin, order, appoint
προστάτης	champion, leader
προστρέχω	run up, run to
προσφέρω	bring to
προσχωρέω	go over to
πρόσωπον	face
πρότερος, η, ον	beforehand, before
προτίθημι	expose, propose
προτιμάω	prefer
προτρέπω	persuade
πρότριτα	three days before
προφασίζομαι	set up as excuse
προφέρω	bring forward
προχοῦς	pitcher
προχωρέω	go forward, go on, succeed
πρύμνα	stern (of a ship)
πρυτανεῖον	town-hall
πρωΐ	early in the morning
πρῶτος, η, ον	first, in the first place, noblest
πτερὸν	wing
πτηνός, ή, όν	winged
πτωχός	beggar
πύλη	gate
πυνθάνομαι	ascertain, hear, learn
πῦρ	fire
τὰ πυρά	watch fires, signal fires
ἡ πυρά	funeral pyre
πύργος	tower
πωλέω	sell
πώλησις	sale
πῶμα	drink, draught; cup for drinking
πῶς	how? πως = somehow
ῥᾴδιος, α, ον	easy
ῥᾳδίως	easily
ῥαπίζω	thrash, beat, cudgel
ῥαφανίς	radish
ῥαψῳδός	rhapsode, minstrel, bard
ῥᾴων, ον	easier
ῥεῖθρον	stream
ῥέω	flow
ῥήγνυμι	break, burst, cleave asunder
ῥῆμα	saying
ῥῆσις	expression
ῥήτωρ	orator
ῥινόκερως	rhinoceros
ῥίπτω	throw
ῥίς	nose, snout
ῥοία	pomegranate
ῥόπαλον	club
ῥύμη	onset
ῥώμη	strength
ῥώννυμι	strengthen; (pass.) be strong, be well
σαίνω	(of dogs) wag the tail, fawn upon
σάλπιγξ	trumpet
σαπρός, ά, όν	musty
σάπφειρος	sapphire
σάρισα	pike (Macedonian weapon)
σάρξ	flesh
σατραπεία	satrapy
σατράπης	satrap
σβέννυμι	quench, put out; (pass.) go out (fire)
σεισμός	earthquake
σεμνύνομαι	be proud, exalt oneself
σεμνῶς	solemnly
σηκός	pen, fold (for lambs & calves); sacred enclosure (dedicated to a hero)
σῆμα	sign
σημαίνω	give a sign, signal
σήμαντρον	seal
σημεῖον	sign, signal
σθένος	strength
σῖγα	silently
σιγάω	be silent, hold one's peace
σιγή	silence
σίδηρος	iron
σιδηροφορέω	habitually carry arms; bear arms
σιμός, ή, όν	blunt
σιτέω	eat, feed on, dine
σίτησις	feeding, maintenance
σιτίον	food provisions
σιτοδεία	scarcity of food
σῖτος	food
σιωπάω	keep silent
σιωπή	silence
σκάφιον	trough
σκεδάννυμι	scatter
σκέλος	leg
σκευάζω	prepare, dress up
σκηνή	tent, booth
σκόλοψ	stake
σκοπέω	look, see, look at
σκοπός	mark, target, goal, aim
σκότος	darkness, the dark
σκύλαξ	puppy
σκῦλα	spoils (of war); plunder
σκυτοτόμος	cobbler
σκώπτω	scoff at, mock, make fun of
σός, σή, σόν	your, yours (singular)
σοφία	cleverness, skill, wisdom
σοφιστής	philosopher, teacher, tutor; sophist
σοφιστικός, ή, όν	contentious, argumentative
σοφός, ή, όν	clever, skilled, wise
σπανίζω	be in want of
σπαράσσω	tear, mangle
σπάρτον	rope, cord
σπάω	draw, pull
σπείρω	sow
σπένδω	pour; (mid.) make a treaty, make a truce, agree
σπέρμα	seed
σπεύδω	be eager, be anxious to
σπονδή	libation; (plu.) truce, treaty
σποράς	scattered
σπουδάζω	be busy, be zealous, pursue zealously
σπουδαῖος, α, ον	zealous, eager, earnest
σπουδῆ	zeal, haste
στάδιον	race course; a stadion (606 feet; 185 metres)
σταθμός	stall, resting-station, stage (of a journey)
στασιάζω	quarrel, dispute, be at variance
στατήρ	stater (type of gold/silver coin)
σταυρός	palisade
στενόπορα	narrow passes
στενός, ή, όν	narrow
στέργω	be fond of
στερεότης	stiffness, hardness
στερίσκω	rob, deprive
στέφανος	wreath
στεφανόω	crown
στήλη	grave stone, pillar
στοά	colonnade
στοῖχος	row, file
στολή	dress
στόμα	mouth
στορέννυμι	spread (a mat on the floor, etc.); lay out
στοχάζομαι	aim at, take aim
στρατεία	expedition
στράτευμα	armament
στρατεύω	march; (mid/pass) serve as a soldier
στρατηγέω	be a general, lead
στρατηγία	command (of an army)
στρατήγιον	general's tent
στρατηγός	general
στρατία	army
στρατιώτης	soldier
στρατοπεδεύομαι	encamp
στρατόπεδον	camp
στρατός	army
στρεβλόω	screw up, distort, dislocate
στρέφω	turn, twist
συβώτης	swineherd
συγγενής, ές	akin
συγγνώμη	forgiveness
συγγράφω	compose, compile
συγκαθεύδω	sleep with
συγκαλέω	call together
συγκαλύπτω	wrap up
συγκατακαίω	burn with
συγκλαίω	join in lamenting
συγχωρέω	agree to, allow
συλάω	despoil
συλλαμβάνω	seize; assist, join in (an undertaking)
συλλέγω	collect
συλλήβδην	all at once
σύλλογος	gathering
συμβαίνω	come to an agreement; happen, befall
σύμβασις	agreement
συμβολή	encounter
συμβουλεύω	advise, recommend; (mid.) take counsel with
συμμαχία	alliance
σύμμαχος	ally
συμμένω	keep together
σύμμετρος, ον	close fitting, suitable
σύμπας, ασα, αν	all together, all at once
συμπέμπω	send with
συμπίπτω	encounter
συμπόσιον	drinking-party
συμφορά	misfortune
σὺν	with, together with, with the help of
συνάγω	collect, assemble, gather together
συνᾴδω	accord with
συναθροίζω	gather together
συνακολουθέω	follow along with
συναμφότεροι, αι, α	both together
συνάπτω	join
συνείδως	conscious of, feeling guilty of
συνεκφέρω	join a funeral
συνεπιλαμβάνομαι	take part with
συνέρχομαι	come together
συνετός, ή, όν	intelligent, learned, having good sense
συνετῶς	cleverly
συνέχω	hold together, sieze
συνεχῶς	continually, constantly
συνηγορέω	advocate, be one's advocate
συνήθης, ες	acquainted, habitual; an acquaintance
συνθήκη	agreement, covenant
σύνθημα	a preconcerted signal, anything agreed upon
συνθνήσκω	die with
συνίστημι	put together; (mid/pass) come together
σύνοιδα	be conscious of
συντίθημι	compose, agree upon, make an agreement
συντρίβω	knock together
σύντροφος, ον	native
συσκευάζω	pack up
συσκοτάζω	grow dark
σύστασις	conflict
συχνὰ	often
σφαγὴ	throat
σφάζω	slaughter
σφεῖς	they, themselves
σφενδόνη	sling
σφέτερος, α, ον	their own
σφόδρα	very, exceedingly
σφοδρός, ά, όν	violent, excessive
σφραγίζω	seal, seal up
σφραγῖς	signet, ring
σχεδόν	nearly
σκῆμα	figure; (plu.) gestures
σχολάζω	be at leisure
σχολαῖος, α, ον	slow
σχολαίτερος	slower
σχολαίως	leisurely, slowly
σχολή	leisure, spare time
σχολῇ	leisurely
σώζω	preserve, save, keep; (pass.) escape
σῶμα	body
σωτηρία	safety
σωφρονίζω	control
σώφρων, ον	of sound mind, self controlled, reasonable
ταλαιπωρέομαι	be distressed
τάλαντον	talent (unit of measurement)
ταξίαρχος	commander
ταπεινός, ή, όν	low, lowly, humble, submissive
ταράσσω	trouble, disturb, disquiet
ταραχῆ	confusion
τάσσω	arrange, draw up
ταὐτὸ	τὸ αὐτό = the same
ταφή	burial, funeral
τάφος	burial, tomb
ταχέως	quickly
τάχιστα	most quickly
τάχος	speed
διὰ τάχους	with all speed
ταχύς, εῖα, ύ	quick, hasty
ταχυτής	speed
τε	both...and
τέγος	roof
τείνω	stretch
τειχίζω	fortify
τείχισμα	fort
τειχομαχέω	conduct a siege
τεῖχος	wall, fort
τεκμήριον	token, proof
τέκνον	child
τεκτονικός, ή, όν	skilled in building
τελευτάω	finish, end; die
τελευτή	end, death
τελέω	accomplish
τέλος	end; at last
τέμενος	precincts
τέμνω	cut
τέρας	portent, monster
τερατώδης, ες	marvellous
τερπνός, ή, όν	agreeable, pleasant
τέρψις	enjoyment
τεσσαράκοντα	forty
τέσσαρες, α	four
τέταρτος, η, ον	fourth
τετραίνω	pierce
τετρακόσιοι, αι, α	400
τετραλογία	tetralogy (four plays connected into one story)
τετράπους, ουν	four-footed
τέχνη	art, craft
τέχνημα	work of art
τέως	for a time, awhile
τήθη	grandmother
τήκω	melt
τηλικοῦτος, αύτη, οῦτο	so great, so large, so old
τηρέω	keep
τήρησις	(noun) guarding, keeping, observance
τί	why? what?
τιάρα	tiara
τίθημι	lay down
τίκτω	beget, bear children
τιμάω	honour, value, esteem
τιμή	(noun) honour
τίμιος, α, ον	precious, honourable
τιμωρέω	help; (mid.) punish, take revenge on
τιμωρία	vengeance, revenge, punishment
τίνω	pay, render
τίς, τί	who? which? what?; τις = a certain one, someone, anyone, something
τιτρώσκω	hurt, wound
τοι	so, yet
τοιγαροῦν	well then, accordingly
τοίνυν	so
τοιόσδε, τοιάδε, τοιόνδε	such, like so
τοιοῦτος, τοιαύτη, τοιοῦτο	such
τολμάω	dare, venture to
τολμηρός, ά, όν	daring
τολμηρῶς	boldly
τόνος	tone
τοξεύω	shoot
τόξον	bow
τοξότης	archer
τόπος	place
τοσόσδε, τοσήδε, τοσόνδε	so great, so much
τοσοῦτος, -αύτη, -οῦτο	so great, as great, so much, as much
τότε	then, at that time
τραγῳδοποιός	tragedian, tragic poet
τράπεζα	table
τραῦμα	wound, hurt
τραυματίζω	wound
τραχηλός	neck
τραχύς, εῖα, ύ	rough, rugged
τρεῖς, τρία	three
τρέμω	tremble
τρέπω	turn, put to flight
τρέφω	breed, rear (offspring)
τρέχω	run
τριάκοντα	thirty
τριακόσιοι	three hundred
τρίβω	rub, pound, bruise
τριήρης	trireme
τρίπηχυς, υ	of three cubit's height or length
τρὶς	three times
τρίτος, η, ον	third
τρόπαιον	trophy (ie. monument to an enemy's defeat)
τροπή	rout, flight
τρόπος	manner, fashion
τροφή	food, rearing
τροφός	nurse
τρύβλιον	bowl
τρυγάω	gather or pick grapes
τρυφερός, ά, όν	luxurious
τρυφερῶς	luxuriously
τρύφη	luxury
τρύχω	wear away, tire
τρώγω	gnaw
τρωκτά	dessert, sweet food
τυγχάνω	happen; hit (a mark)
τύμβος	tomb
τύπτω	strike
τυρός	cheese
τυφλός, ή, όν	blind
τύχη	chance, fortune
ὑβρίζω	outrage, insult, behave outrageously
ὕβρις	violence, insult, insolence
ὑγιής, ές	healthy, sound
ὑδάτιον	streamlet, rivulet
ὑδρία	water bucket
ὕδωρ	water
ὑετός	rain, storm
ὑϊδοῦς	grandson
υἱός	son
ὑλακτέω	bark
ὕλη	wood, trees, forest; matter, material
ὑλώδης, ες	woody
ὑμεῖς	you (pl.)
ὑμέτερος, α, ον	your, yours (pl.)
ὑμνεω	sing of
ὑπαγω	bring
ὑπακούω	listen, answer; obey
ὑπαλείφω	anoint
ὑπάρχω	be
ὑπὲρ	(gen.) on behalf of, for the sake of; (acc.) beyond
ὑπέραισχρος	exceedingly ugly
ὑπερβαίνω	overflow, exceed
ὑπερβάλλω	outdo, surpass
ὑπερεκπλήσσω	astonish beyond measure
ὑπερέχω	surpass, excel
ὑπερήδομαι	be delighted beyond measure
ὑπερηφανία	arrogance
ὕπερθε(ν)	from above, over
ὑπερμεγέθης, ες	enormous
ὐπερφέρω	carry over
ὑπερφυῶς	excessively, wonderfully
ὑπήκοος, ον	subject
ὑπηρετέω	serve
ὑπηρέτης	servant
ὑπισχνέομαι	undertake
ὑπὸ	(gen.) by, owing to; (dat.) under; (acc.) under, towards)
ὑποβάλλω	put under
ὑπόγειος, ον	underground
ὑποδύνω	slip in under
ὑπόκρισις	elocution, delivery
ὑποκριτής	actor
ὑπολαμβάνω	reply, take up
ὑπολείπω	leave behind; (pass.) lag behind
ὑπομένω	endure, put up with, support
ὑπομιμνήσκω	remind
ὑπονοέω	suspect
ὑποπέμπω	send secretly
ὑποσκελίζω	trip up, upset
ὑπόσπονδος, ον	under treaty
ὑποτελέω	pay
ὑπουργέω	serve
ὑποχωρέω	retire
ὑποψία	suspicion
ὕπτιος, α, ον	on one's back; turned upside down
ὗς	boar, pig
ὑστεραῖος, α, ον	following
τῇ ὑστεραίᾳ	on the next day
ὑστερέω	come short of, lack
ὕστερος, α, ον	after, behind; afterwards
ὑψηλός, ή, όν	high
ὕψος	height
φαίνω	show; (mid/pass) appear
φαλάγγιον	venomous spider
φάλαγξ	phalanx
φανερός, ά, όν	visible, conspicuous, evident
φανερῶς	openly, evidently
φάρμακον	drug, medicine, cure, poison
φάσκω	say, allege (usually something untrue)
φάτνη	manger
φαῦλος, η, ον	vulgar, paltry, mean
φειδίτιον	public meal
φείδομαι	spare; be over-careful of
φενακίζω	cheat
φέρω	bring, carry, lead
φεύγω	flee; be prosecuted
φεύγειν δίκην	be put on trial
φήμη	rumour, report
φθάνω	anticipate, do something first/before others
φθέγγομαι	utter, shout
φθείρω	spoil, waste, destroy, kill
φθονέω	envy, grudge, be jealous, spite
φιάλη	cup
φιλάνθρωπος, ον	humane, kind
φιλανθρώπως	kindly
φιλάργυρος, ον	avaricious, greedy, money-loving
φιλέω	love
φιλἰα	friendship
φιλικῶς	in a friendly way, as a friend
φιλόδωρος, ον	bountiful, fond of giving gifts
φιλόκαλος, ον	fond of beautiful things
φιλοκέρδεια	love of grain
φιλοπάισμων, ον	fond of a joke
φιλοπονία	industry
φιλόπονος, ον	industrious, diligent
φίλος, η, ον	loved, dear; a friend
φιλοσοφέω	study philosophy
φιλόσοφος, ον	philosophical, philosophy
φιλοτιμέομαι	vie, contend (for some honour)
φιλοφρόνως	kindly
φιλοψυχέω	value one's life
φίλτατος	superlative of φίλος
φλέγω	burn, blaze
φλόξ	flame
φλυαρέω	talk nonsense
φλυαρία	nonsense, absurdity
φοβερός, ά, όν	fearful
φοβέομαι	fear, be frightened
φόβος	fear
φονεύω	massacre, butcher
φόνος	murder, slaughter
φορέω	carry, bear
φόρος	tribute
φορτικός, ή, όν	vulgar, common, paltry
φορτίον	load
φράζω	tell
φρονέω	think, be disposed
φροντίζω	think
φρουρὰ	guard
φρούραρχος	commandant, commander (of a guard)
φρουρέω	keep guard, watch
φρούριον	fort
φρυάσσομαι	neigh
φρυκτωρέω	signal
φυλακή	guard, garrison
φύλαξ	guard, keeper
φυλάσσω	watch, keep, guard; (mid.) defend oneself
φυλή	tribe
φυσικός, ή, όν	physical, natural
φύσις	nature
φυτεύω	(verb) plant
φυτόν	(noun) plant
φύω	produce; (mid./pass.) be born
φωνέω	produce a sound, speak (loudly/clearly), call
φωνἠ	voice, utterance
φώρ	thief
φωράω	detect
φῶς	light
χαίρω	rejoice, be pleased
χαλεπαίνω	enrage
χαλεπός, ή, όν	hard, harsh, angry, hard to bear, grievous
χαλεπότης	ruggedness
χαλεπῶς	roughly, hardly
χαλκός	brass, copper
χαλκοῦς, ῆ, οῦν	brazen, copper
χαράδρα	torrent, ravine
χάραξ	vinepole
χαρίζομαι	present, gratify
χάρις	thanks, gratitude, favour
χάσμα	chasm
χαῦνος, η, ον	vain
χεῖλος	lip, edge, bring
χειμῶν	winter
χείρ	hand
χειροτονέω	elect
χελιδών	swallow (bird)
χήν	goose
χθές	yesterday
χιλίαρχος	captain of a thousand
χίλιοι, αι, α	thousand
χιτών	shirt
χλαῖνα	cloak, coat
χοιροκομεῖον	pigsty
χοῖρος	pig
χορεύω	dance
χράομαι	use, experience, enjoy; consult (oracle)
χρεία	need
χρέος	debt
χρή	(impersonal) it is right, one ought, one should
χρῄζω	want, require
χρῆμα	thing; (plu.) goods, money
χρηματίζομαι	negotiate, bargain, do business
χρηματοφθορικός, όν	extravagant, wasteful
χρήσιμος, η, ον	serviceable, fit
χρησμολόγος	soothsayer
χρησμός	oracle
χρόνος	time
χρυσός	gold
χρυσοῦς, ῆ, οῦν	golden
χρῶμα	colour
χώνη	funnel, pipe
χώρα	country
χωρέω	withdraw, advance, proceed; hold, contain, have room for
χωρίζω	separate
χωρίον	place, stronghold
χωρίς	apart from
ψάμαθος	sand
ψέγω	blame, find fault with
ψευδής, ές	false; liar
ψεύδομαι	lie, tell falsehoods
ψεῦδος	lie, falsehood
ψευδῶς	falsely
ψηφίζομαι	vote for
ψῆφος	vote; pebble used for voting
ψοφέω	sound
ψυχή	soul, life
ψυχρός, ά. όν	cold
ὦ	interjection, oh!
ὧδε	thus, so, as follows
ὠδικός, ή, όν	singing
ὠθέω	thrust
ὦμος	shoulder and upper arm
ὠμότης	ferocity
ὠμῶς	savagely, cruelly
ὠνέομαι	buy
ὥρα	time, hour
ὡραῖος, α, ον	ripe
ὡς	as, that, to
ὡσεὶ	as though
ὥσπερ	just as
ὥστε	(with inf.) so as, as; (with finite verbs) so that, that
ὠφέλιμος, η, ον	advantageous, to one's profit
